dirt.txt
111111111111111111111111111111111111111111111111111111111111111111111111111111111111111311111111111111111111111111111111111111111111111
111111111111111111111111122222222222222111111111111111111111111111111111112222222222222222211111111111111111111111111111111111111111111
111111111111111111311111111111111111111111111111111111111111111111111111111111111111111111111111111111111111111111111111111111111111111
111111111111111111111111111111111111111111111111111111111111111111111111111111111113111111111111111111111111111111111111111111111111111
111111111111111111111111111111111111111111111111111111111111111111111111111111111111111111111111111111111111111111111111111111111111111
111111111111111111111111111111111111111111111111111111111111111111111112222222111111111111111111111111111111111111111111111111111111111
1111111111111111111..P........111111111111111111111111111111111112222222222222221111111111111111111111111111111111111111111111111111111
111111111111111111111111111111111111111111111111111111111111112222222222222222222222222222221111111111111111222222222211111111111111111
111111111111111111111111111111111111111111111111111111111111111111111111111111111111111111111111111111111111222222222222222111111111111
111111111111111111111111111111111111111112222222222221111111111111111111111111111111111111111111111111112222222222222222211111111111111
111111111111111122222222111111111111111111111111111111111111111111111111111111111111111111111111111111111111111111111111111111111111111
111111111111111111112222222211111111111111111111111111111111111111111111111111111111111111111111111111111111111111111111111111111111111
111111111111111112222222222222111111111111111111111131111111111222222222222221111111111111111111111111111111111111111111111111111111111
111111111111111111111111111111111111111111111111111111111111111111111111111111111111111111111111112222211111111111311111111111111111111
111111111111111111111111111111111111111111111111111111111111111111111111111111111111111112222222222222111111111111111111111111111111111
111111111111111111111111111111111111111111111111111111111111111111111111111111111222222222222222222222111111111111111111111111111111111
111111111111111131111111111111111111111111111111111111111111222111111111111111111112222222222222222111111111111111111111111111111111111
111111111111111111111112222222222222211111111111111122222222222222222222222211111111111111111111111111111111111111111111111111111111111
111111111111111111111111111122222222222111111111111111111112222222222222111111111111111111111111111111111111111111111111111111111111111
111111111111111111111111122222222222221111111111111111111111111111111111111111111111111113111111111111111111111111111111111111111111111
111111111111111111111111111111111111111111111111111111111111111111111111111111111111111111111111111111111111111111111111111111111111111
111111111222222222221111111111111111111111111111111311111111111111111111111111111112222222222222222222111111113111111111111111111111111
111111111111111222222222222211111111111111111111111111111111113111111111111111111111111111112222222222211111111111111111111111111111111
111111111111111222222222222211111111111111111111111111111111111111111111111111111112222222222222111111111111111111111111111111111111111
111111112222222222222222222222221111111111111111111111111111111111111111111111111111111111111111111111111111111111222222222222222111111
111111111111112222222222222222211111111111111111111111111111111111111111111111111111111111111111111111131111122222222222221111111111111
111111111111111111111222222222222111111111111111111111111111111111111111111111111111111111111111111111111111111111111111111111111111111
111111111131111111111111111111111111111111111111111122222222111111111111111111111111222222222222221111111111111111111111111111111111111
111111111111111111111111111111111111111111111111111122222221111111111111111111111111132222221111111111111111111111111111111111111111111
111111111111111111111111111111111111111111111111111222222221111111111111111112222222222222222222222111111111111111111111111111111111111
111111111111111111111111111111111111111122222222222221111111111111111111111111111111111111111111111111111111111111111111111111111111111
111111111111111111111111111111111111111111111111111111111111111111111111111111111111111311111111111111111111111111111111111111111111111
111111111111111111111111111111111311111111111111111111111131111111111111111111111111111111111111111111111111111111111111111111111111111
111111111111111111222222222211111111111111111111111111111111111111111111111111111111111111111111111111111111111111111111211112222222222
111111222222222222222222222222222111111111111111111111111111111111111111112222222222222111111111111111111111111111122222222222222222222
222222222222222222222222222222222222222222222222222222222222222222222222222222222222222222222222222222222222222222222222222222222222222

endScreen.txt
11111111111111111111111111111111
1..............................1
1..............................1
1..............................1
1..............................1
1..............................1
1..............................1
1..............................1
1..............................1
1..............................1
1..............................1
1..............................1
1..............................1
1..............................1
1..P...........................1
1..............................1
1..............................1
1..............................1
1....F.........................1
1..............................1
1..............................1
11111111111111111111111111111111

flowerField.txt
111111111111111111111111111111111111111111111111111111111111111111111111111111111111111111111111111111111111111111111111111111111111111111111111
1..............................................................................................................................................1
1..............................................................................................................................................1
1..............................................................................................................................................1
1..............................................................................................................................................1
1..............................................................................................................................................1
1....P.........................................................................................................................................1
1..............................................................................................................................................1
1..............................................................................................................................................1
1..............................................................................................................................................1
1..............................................................................................................................................1
1..............................................................................................................................................1
1..............................................................................................................................................1
1..............................................................................................................................................1
1.................................................................................................................................t............1
1........................................................................................................f.....................................1
1......................................................f.......................................................................................1
1................................f..............f.......................f...................f..................................................1
1..................................................................................................f..............................h............1
1......................f...................f..................f..........................................................................F.....1
1...................................................................................f..........................................................1
1..............................................................................................................................................1
222222222222222222222222222222222222222222222222222222222222222222222222222222222222222222222222222222222222222222222222222222222222222222222222
222222222222222222222222222222222222222222222222222222222222222222222222222222222222222222222222222222222222222222222222222222222222222222222222

flowerField2.txt
111111111111111111111111111111111111111111111111111111111111111111111111111111111111111111111111111111111111111111111111111111111111111111111111
1..............................................................................................................................................1
1..............................................................................................................................................1
1..............................................................................................................................................1
1..............................................................................................................................................1
1..............................................................................................................................................1
1....P.........................................................................................................................................1
1..............................................................................................................................................1
1..............................................................................................................................................1
1..............................................................................................................................................1
1..............................................................................................................................................1
1..............................................................................................................................................1
1......................................................f.......................................................................................1
1......................f.......................................................................................................................1
1.................................................................................................................................t............1
1...............................................................f........................................f.....................................1
1................f...........f.................................................................................................................1
1................................f..............f...........................................f..................................................1
1..................................................................................................f............f.................h............1
1..........................................f.............................................................................................F.....1
1.....................................................................f.............f..........................................................1
1..............................................................................................................................................1
222222222222222222222222222222222222222222222222222222222222222222222222222222222222222222222222222222222222222222222222222222222222222222222222
222222222222222222222222222222222222222222222222222222222222222222222222222222222222222222222222222222222222222222222222222222222222222222222222

gameOver.txt
22222222222222222222222222222222
2..............................2
2..............................2
2..............................2
2..............................2
2..............................2
2..............................2
2..............................2
2111.1..1.111..111.11...1.111..2
2.1..1..1.1....1...111..1.1.11.2
2.1..1111.111..111.1.11.1.1..1.2
2.1..1..1.1....1...1..111.1.11.2
2.1..1..1.111..111.1...11.111..2
2..............................2
2..............................2
2..............................2
2..............................2
2..............................2
2...........................F..2
2..............................2
2...P..........................2
22222222222222222222222222222222

home.txt
................................
1..............................1
1..............................1
1..............................1
1..............................1
1..............................1
1..............................1
1..............................1
1..............................1
1..............................1
1..............................1
1..............................1
1..............................1
1..............................1
1....b....................w....1
1..............................1
1..............................1
1..............................1
1..............P...............1
1..............................1
1..............................1
11111111111111111111111111111111
